1 15 18
##################
#p               #
#*#*#*#*#*#*#*#* #
#    g           #
# *#*#*#*#*#*#*#*#
#        g       #
# *#*#*#*#*#*#*#*#
#             g  #
#*#*#*#*#*# #*#*##
#     g          #
#*#*#*#* #*#*#*#*#
#           g    #
# #*#*#*#*##*#*#*#
#       g        #
##################   