1 13 30
ss##########################ss
sp     ** *    *   *  * * *  s
# # # #*# # #*#*# # # #*#*#*##
#   *  g  ***  *   g  *   * *#
# #s# # # #*# # #*#*# # # # ##
#f           **  *  *        #
# # # # # # # # # #*# #*# # ##
#*  *  g   *  *   g  * g     #
# # # # #*# # # #*#*# # # # ##
#*    **  *       *      g   #
# #*# # # # # # #*# # # # # ##
s    g      *   *  *     g   s
ss##########################ss